.button.red	Link: Button - Red
.linkedimage	Link: Image
.subContent	Content: Sub-Content	block
.tableGrid	Content: Grided Table	block
.subLink	Content: Grided Table Link Indent
.leftAlign	Content: Grided Table Text Left Align	block
.section	Content: Grided Table Section	block
.section-item	Content: Grided Table Section Item	block
.overlaySlideShow	Media: Overlay Slideshow
.inlineSlideShow	Media: Inline Slideshow
.instantInlineSlideShow	Media: Instant-Inline Slideshow
.overlayVideo	Media: Overlay Video
.inlineVideo	Media: Inline Video
.overlayQuicktime	Media: Overlay Quicktime
.inlineAudio	Media: Inline Audio
.instantInlineAudio	Media: Instant-Inline Audio
.inlineSWF	Media: Inline SWF
.instantInlineSWF	Media: Instant-Inline SWF
.overlaySWF	Media: Overlay SWF
.overlayIMG	Media: Overlay Image
.profile	Profiles: Thumbnail	block
.profile	Profiles: Name Heading	block
